amc,folio,pan,scheme,advisor,isin,amfi,date,description,amount,units,nav,balance,type,dividend
AXIS Mutual Fund,91057795155 / 0,AVYPR0077R,Axis Small Cap Fund Direct Growth,,INF846K01K35,125354,2019-08-02,Systematic Investment (1/6),5000.00,171.939,29.08,171.939,PURCHASE_SIP,
AXIS Mutual Fund,91057795155 / 0,AVYPR0077R,Axis Small Cap Fund Direct Growth,,INF846K01K35,125354,2019-09-03,Systematic Investment (2/6),5000.00,163.881,30.51,335.820,PURCHASE_SIP,
AXIS Mutual Fund,91057795155 / 0,AVYPR0077R,Axis Small Cap Fund Direct Growth,,INF846K01K35,125354,2019-10-03,Systematic Investment (3/6),5000.00,156.055,32.04,491.875,PURCHASE_SIP,
AXIS Mutual Fund,91057795155 / 0,AVYPR0077R,Axis Small Cap Fund Direct Growth,,INF846K01K35,125354,2019-11-04,Systematic Investment (4/6),5000.00,147.145,33.98,639.020,PURCHASE_SIP,
AXIS Mutual Fund,91057795155 / 0,AVYPR0077R,Axis Small Cap Fund Direct Growth,,INF846K01K35,125354,2019-12-02,Systematic Investment (5/6),5000.00,149.254,33.50,788.274,PURCHASE_SIP,
AXIS Mutual Fund,91057795155 / 0,AVYPR0077R,Axis Small Cap Fund Direct Growth,,INF846K01K35,125354,2020-01-02,Systematic Investment (6/6),5000.00,145.180,34.44,933.454,PURCHASE_SIP,
AXIS Mutual Fund,91057795155 / 0,AVYPR0077R,Axis Small Cap Fund Direct Growth,,INF846K01K35,125354,2020-03-20,Purchase,10000.00,353.607,28.28,1287.061,PURCHASE,
AXIS Mutual Fund,91057795155 / 0,AVYPR0077R,Axis Small Cap Fund Direct Growth,,INF846K01K35,125354,2020-09-25,"Redemption less TDS, STT",-45030.19,-1287.061,34.99,0.000,REDEMPTION,
AXIS Mutual Fund,91057795155 / 0,AVYPR0077R,Axis Small Cap Fund Direct Growth,,INF846K01K35,125354,2020-09-25,*** STT Paid ***,0.45,,,,STT_TAX,
